"";"date";"total_cases";"total_deceased";"total_recovered";"uci_cases";"new_cases";"new_deceased";"new_recovered";"incidence_14d";"daily_antic";"daily_antig";"daily_pcr";"daily_hosp_lar";"daily_hosp_lie";"daily_hosp_sie";"daily_hosp_3ma";"daily_hosp_val";"daily_hosp_total";"daily_uci_sie";"daily_uci_val";"daily_uci_total";"active";"daily_test";"daily_positiv";"rate_pcr_7d";"rate_hosp_ocup";"rate_ucis_ocup"
"1";2020-02-29;1;0;0;0;NA;NA;NA;0;NA;NA;NA;0;0;1;0;0;1;0;0;0;1;NA;NA;0;0,0644745325596389;0
"2";2020-03-01;1;0;0;0;0;0;0;0;0;0;0;0;0;1;0;0;1;0;0;0;1;0;NA;0;0,0644745325596389;0
"3";2020-03-02;10;0;0;0;9;0;0;0;0;0;10;0;0;1;0;0;1;0;0;0;10;10;0,9;0;0,0644745325596389;0
"4";2020-03-03;10;0;0;0;0;0;0;0;0;0;24;0;0;1;0;0;1;0;0;0;10;24;0;0;0,0644745325596389;0
"5";2020-03-04;10;0;0;0;0;0;0;0;0;0;24;0;0;1;0;0;1;0;0;0;10;24;0;0;0,0644745325596389;0
"6";2020-03-05;10;0;0;0;0;0;0;0;0;0;4;0;0;1;0;0;1;0;0;0;10;4;0;0;0,0644745325596389;0
"7";2020-03-06;11;0;0;0;1;0;0;0;0;0;4;0;0;1;0;0;1;0;0;0;11;4;0,25;0;0,0644745325596389;0
"8";2020-03-07;12;0;0;0;1;0;0;0;0;0;5;0;0;1;0;0;1;0;0;0;12;5;0,2;22,5;0,0644745325596389;0
"9";2020-03-08;12;0;0;0;0;0;0;0;0;0;5;0;0;1;0;0;1;0;0;0;12;5;0;19,2857142857143;0,0644745325596389;0
"10";2020-03-09;12;0;0;0;0;0;0;0;0;0;7;0;0;1;0;0;1;0;0;0;12;7;0;6,42857142857143;0,0644745325596389;0
"11";2020-03-10;12;0;3;0;0;0;3;0;0;0;15;0;0;1;0;0;1;0;0;0;9;15;0;6,42857142857143;0,0644745325596389;0
"12";2020-03-11;12;0;4;1;0;0;1;0;0;0;34;0;0;2;0;2;4;0;1;1;8;34;0;6,42857142857143;0,257898130238556;0,869565217391304
"13";2020-03-12;20;0;4;1;8;0;0;0;0;0;45;0;0;2;0;3;5;0;1;1;16;45;0,177777777777778;8,96825396825397;0,322372662798195;0,869565217391304
"14";2020-03-13;32;0;5;1;12;0;1;6;0;0;50;0;0;2;0;4;6;0;1;1;27;50;0,24;8,82539682539683;0,386847195357834;0,869565217391304
"15";2020-03-14;49;0;5;3;17;0;0;8;0;0;104;0;0;2;0;7;9;0;3;3;44;104;0,163461538461538;8,3034188034188;0,58027079303675;2,60869565217391
"16";2020-03-15;58;0;6;3;9;0;1;10;0;0;78;0;0;2;0;8;10;0;3;3;52;78;0,115384615384615;9,95177045177045;0,644745325596389;2,60869565217391
"17";2020-03-16;61;0;6;3;3;0;0;9;0;0;60;0;0;4;1;9;14;0;3;3;55;60;0,05;10,6660561660562;0,902643455834945;2,60869565217391
"18";2020-03-17;78;1;6;4;17;1;0;12;0;0;135;1;0;7;1;18;27;0;4;4;71;135;0,125925925925926;12,464997964998;1,74081237911025;3,47826086956522
"19";2020-03-18;114;1;6;5;36;0;0;18;0;0;167;1;0;11;2;32;46;1;4;5;107;167;0,215568862275449;15,5445531403615;2,96582849774339;4,34782608695652
"20";2020-03-19;169;1;6;7;55;0;0;27;0;0;233;4;0;14;3;53;74;1;6;7;162;233;0,236051502145923;16,3770349170493;4,77111540941328;6,08695652173913
"21";2020-03-20;228;3;6;7;59;2;0;37;0;0;336;6;0;18;3;67;94;1;6;7;219;336;0,175595238095238;15,4569668898384;6,06060606060606;6,08695652173913
"22";2020-03-21;296;6;6;11;68;3;0;49;0;0;288;11;0;25;3;82;121;2;9;11;284;288;0,236111111111111;16,4948179276895;7,80141843971631;9,56521739130435
"23";2020-03-22;368;8;6;15;72;2;0;61;0;0;284;15;0;31;6;95;147;1;14;15;354;284;0,253521126760563;18,4681966616316;9,47775628626692;13,0434782608696
"24";2020-03-23;444;12;6;20;76;4;0;74;0;0;294;18;0;43;8;118;187;4;16;20;426;294;0,258503401360544;21,4468166810679;12,0567375886525;17,3913043478261
"25";2020-03-24;532;17;8;22;88;5;2;89;0;0;709;33;0;53;9;142;237;5;17;22;507;709;0,124118476727786;21,4209959782373;15,2804642166344;19,1304347826087
"26";2020-03-25;712;19;11;24;180;2;3;120;0;0;648;50;0;72;13;163;298;5;19;24;682;648;0,277777777777778;22,3096947711278;19,2134107027724;20,8695652173913
"27";2020-03-26;855;25;12;29;143;6;1;144;0;0;721;61;0;85;12;187;345;6;23;29;818;721;0,198335644937587;21,7708968110087;22,2437137330754;25,2173913043478
"28";2020-03-27;953;28;14;36;98;3;2;158;0;0;634;61;0;98;14;194;367;8;28;36;911;634;0,154574132492114;21,4705953023926;23,6621534493875;31,304347826087
"29";2020-03-28;1038;31;18;38;85;3;4;170;0;0;486;65;0;100;14;212;391;8;30;38;989;486;0,174897119341564;20,5961097056848;25,2095422308188;33,0434782608696
"30";2020-03-29;1125;34;18;41;87;3;0;184;0;0;313;60;0;103;14;209;386;9;32;41;1073;313;0,277955271565495;20,9451689171838;24,8871695680206;35,6521739130435
"31";2020-03-30;1183;49;20;45;58;15;2;193;0;0;495;52;0;111;14;226;403;11;34;45;1114;495;0,117171717171717;18,9261448573434;25,9832366215345;39,1304347826087
"32";2020-03-31;1240;60;30;47;57;11;10;200;0;0;592;51;0;105;15;215;386;12;35;47;1150;592;0,0962837837837838;18,5285063867148;24,8871695680206;40,8695652173913
"33";2020-04-01;1278;64;44;47;38;4;14;200;0;0;632;45;5;96;11;203;360;12;35;47;1170;632;0,060126582278481;15,4192035938677;23,21083172147;40,8695652173913
"34";2020-04-02;1351;72;52;47;73;8;8;203;0;0;627;33;14;91;12;205;355;12;35;47;1227;627;0,116427432216906;14,2490862692866;22,8884590586718;40,8695652173913
"35";2020-04-03;1420;74;79;47;69;2;27;205;0;0;584;33;18;89;13;205;358;12;35;47;1267;584;0,118150684931507;13,7287513041351;23,0818826563507;40,8695652173913
"36";2020-04-04;1460;79;87;43;40;5;8;200;0;0;507;34;16;84;13;202;349;12;31;43;1294;507;0,0788954635108481;12,357299077982;22,501611863314;37,3913043478261
"37";2020-04-05;1488;87;88;43;28;8;1;193;0;0;207;34;14;89;14;210;361;11;32;43;1313;207;0,135265700483092;10,3188766339476;23,2753062540297;37,3913043478261
"38";2020-04-06;1520;95;109;40;32;8;21;185;20;0;451;30;19;75;15;190;329;9;31;40;1316;471;0,0679405520169851;9,61557427459432;21,2121212121212;34,7826086956522
"39";2020-04-07;1593;99;140;41;73;4;31;182;46;0;680;33;19;80;16;172;320;9;32;41;1354;726;0,100550964187328;9,67653399464495;20,6318504190845;35,6521739130435
"40";2020-04-08;1653;104;169;38;60;5;29;160;51;0;642;36;18;75;17;166;312;10;28;38;1380;693;0,0865800865800866;10,0544411989536;20,1160541586074;33,0434782608696
"41";2020-04-09;1690;108;190;39;37;4;21;141;58;0;396;35;21;77;16;167;316;11;28;39;1392;454;0,0814977973568282;9,55544641523821;20,3739522888459;33,9130434782609
"42";2020-04-10;1758;117;207;36;68;9;17;135;86;0;418;35;20;73;16;167;311;10;26;36;1434;504;0,134920634920635;9,79501712936861;20,0515796260477;31,304347826087
"43";2020-04-11;1784;121;216;35;26;4;9;125;72;0;272;32;21;80;16;162;311;10;25;35;1447;344;0,0755813953488372;9,74767329848274;20,0515796260477;30,4347826086957
"44";2020-04-12;1831;129;230;33;47;8;14;114;29;0;333;33;20;79;19;163;314;9;24;33;1472;362;0,129834254143646;9,67008120791923;20,2450032237266;28,695652173913
"45";2020-04-13;1844;135;243;30;13;6;13;107;0;0;256;30;14;72;18;157;291;8;22;30;1466;256;0,05078125;9,4249483219623;18,7620889748549;26,0869565217391
"46";2020-04-14;1877;141;280;29;33;6;37;101;190;0;631;27;9;65;19;137;257;7;22;29;1456;821;0,0401948842874543;8,56271860910697;16,5699548678272;25,2173913043478
"47";2020-04-15;1902;147;339;26;25;6;59;99;50;0;722;25;14;63;18;131;251;7;19;26;1416;772;0,0323834196891192;7,78848051066458;16,1831076724694;22,6086956521739
"48";2020-04-16;1962;150;387;22;60;3;48;91;379;0;626;19;16;54;16;127;232;5;17;22;1425;1005;0,0597014925373134;7,47710472752865;14,9580915538362;19,1304347826087
"49";2020-04-17;2000;156;445;20;38;6;58;84;321;0;696;11;18;48;16;118;211;4;16;20;1399;1017;0,0373647984267453;6,08344992047308;13,6041263700838;17,3913043478261
"50";2020-04-18;2052;160;465;20;52;4;20;85;125;0;422;13;19;47;16;114;209;4;16;20;1427;547;0,0950639853747715;6,36177263512929;13,4751773049645;17,3913043478261
"51";2020-04-19;2092;164;471;17;40;4;6;86;190;0;462;13;19;51;17;117;217;3;14;17;1457;652;0,0613496932515337;5,38342176524196;13,9909735654417;14,7826086956522
"52";2020-04-20;2124;169;520;18;32;5;49;82;344;0;605;13;19;43;16;110;201;4;14;18;1435;949;0,0337197049525817;5,1396854074217;12,9593810444874;15,6521739130435
"53";2020-04-21;2163;173;593;18;39;4;73;73;586;0;770;10;19;43;16;104;192;4;14;18;1397;1356;0,0287610619469027;4,97634508827096;12,3791102514507;15,6521739130435
"54";2020-04-22;2216;177;659;17;53;4;66;67;915;0;930;9;19;41;15;103;187;4;13;17;1380;1845;0,0287262872628726;4,92410033932458;12,0567375886525;14,7826086956522
"55";2020-04-23;2280;180;728;11;64;3;69;66;1061;0;945;8;16;40;16;73;153;4;7;11;1372;2006;0,0319042871385842;4,52699740505702;9,86460348162476;9,56521739130435
"56";2020-04-24;2318;183;766;9;38;3;38;57;970;0;608;7;13;39;12;68;139;3;6;9;1369;1578;0,0240811153358682;4,33723050375878;8,96196002578981;7,82608695652174
"57";2020-04-25;2334;187;878;9;16;4;112;56;22;0;551;10;12;42;12;70;146;3;6;9;1269;573;0,0279232111692845;3,37807658653754;9,41328175370729;7,82608695652174
"58";2020-04-26;2357;191;929;9;23;4;51;55;14;0;457;7;10;43;12;67;139;3;6;9;1237;471;0,0488322717622081;3,19925627954717;8,96196002578981;7,82608695652174
"59";2020-04-27;2396;192;1000;8;39;1;71;55;847;0;628;5;7;36;12;62;122;3;5;8;1204;1475;0,0264406779661017;3,09527017974031;7,86589297227595;6,95652173913043
"60";2020-04-28;2446;194;1081;9;50;2;81;55;894;0;836;6;5;31;10;57;109;3;6;9;1171;1730;0,0289017341040462;3,09727978198522;7,02772404900064;7,82608695652174
"61";2020-04-29;2512;194;1154;6;66;0;73;55;948;0;1122;6;3;29;9;49;96;2;4;6;1164;2070;0,0318840579710145;3,14239079210153;6,18955512572534;5,21739130434783
"62";2020-04-30;2558;196;1217;6;46;2;63;52;834;0;915;5;0;23;8;43;79;2;4;6;1145;1749;0,0263007432818754;3,06234016557712;5,09348807221148;5,21739130434783
"63";2020-05-01;2587;198;1264;6;29;2;47;50;617;0;830;4;0;23;8;43;78;2;4;6;1125;1447;0,0200414651002073;3,00463087649625;5,02901353965184;5,21739130434783
"64";2020-05-02;2593;200;1319;5;6;2;55;43;156;0;423;4;0;19;6;43;72;1;4;5;1074;579;0,0103626943005181;2,75376634979959;4,642166344294;4,34782608695652
"65";2020-05-03;2595;201;1320;5;2;1;1;38;94;0;145;4;0;17;6;44;71;1;4;5;1074;239;0,00836820083682008;2,17570819372262;4,57769181173436;4,34782608695652
"66";2020-05-04;2607;202;1369;3;12;1;49;36;1284;0;469;3;0;11;4;32;50;0;3;3;1036;1753;0,00684540787221905;1,89577576381001;3,22372662798195;2,60869565217391
"67";2020-05-05;2634;202;1408;3;27;0;39;34;789;0;661;3;0;8;4;28;43;0;3;3;1024;1450;0,0186206896551724;1,74890370025467;2,77240490006447;2,60869565217391
"68";2020-05-06;2649;203;1479;3;15;1;71;33;780;0;928;3;0;7;5;23;38;0;3;3;967;1708;0,00878220140515222;1,41887717788521;2,45003223726628;2,60869565217391
"69";2020-05-07;2682;203;1545;3;33;0;66;31;916;0;1182;3;0;6;5;21;35;0;3;3;934;2098;0,0157292659675882;1,26785607339539;2,25660863958736;2,60869565217391
"70";2020-05-08;2689;204;1629;4;7;1;84;29;697;0;774;4;0;7;4;18;33;1;3;4;856;1471;0,00475866757307954;1,04953039443642;2,12765957446809;3,47826086956522
"71";2020-05-09;2692;204;1692;4;3;0;63;27;52;0;355;5;0;7;4;17;33;1;3;4;796;407;0,00737100737100737;1,00679200972913;2,12765957446809;3,47826086956522
"72";2020-05-10;2693;204;1701;4;1;0;9;23;0;0;128;5;0;7;4;18;34;1;3;4;788;128;0,0078125;0,998853426345983;2,19213410702772;3,47826086956522
"73";2020-05-11;2710;205;1730;4;17;1;29;22;525;0;728;4;0;5;3;13;25;1;3;4;775;1253;0,0135674381484437;1,09488243029205;1,61186331399097;3,47826086956522
"74";2020-05-12;2729;205;1855;4;19;0;125;19;264;0;847;3;0;6;3;12;24;1;3;4;669;1111;0,0171017101710171;1,07318272337555;1,54738878143133;3,47826086956522
"75";2020-05-13;2738;205;1893;2;9;0;38;15;306;0;604;3;0;5;3;10;21;0;2;2;640;910;0,00989010989010989;1,08900998744637;1,35396518375242;1,73913043478261
"76";2020-05-14;2758;206;1928;1;20;1;35;13;595;0;694;4;0;4;4;8;20;0;1;1;624;1289;0,0155159038013964;1,08596195650077;1,28949065119278;0,869565217391304
"77";2020-05-15;2767;206;1986;1;9;0;58;11;332;0;871;4;0;3;3;7;17;0;1;1;575;1203;0,00748129675810474;1,12485665914399;1,09606705351386;0,869565217391304
"78";2020-05-16;2770;208;2053;1;3;2;67;11;23;0;584;4;0;3;3;6;16;0;1;1;509;607;0,00494233937397035;1,09016140204346;1,03159252095422;0,869565217391304
"79";2020-05-17;2773;208;2074;1;3;0;21;11;108;0;467;4;0;4;3;6;17;0;1;1;491;575;0,00521739130434783;1,053088420677;1,09606705351386;0,869565217391304
"80";2020-05-18;2781;208;2109;2;8;0;35;11;581;0;400;2;0;4;3;5;14;0;2;2;464;981;0,00815494393476045;0,97576707476724;0,902643455834945;1,73913043478261
"81";2020-05-19;2786;209;2141;2;5;1;32;11;183;0;884;1;0;4;2;7;14;0;2;2;436;1067;0,00468603561387067;0,798400295379434;0,902643455834945;1,73913043478261
"82";2020-05-20;2795;209;2193;1;9;0;52;9;204;0;741;2;0;1;1;5;9;0;1;1;393;945;0,00952380952380952;0,793167433003714;0,58027079303675;0,869565217391304
"83";2020-05-21;2800;209;2248;1;5;0;55;7;360;0;852;1;0;2;1;6;10;0;1;1;343;1212;0,00412541254125413;0,630446129287395;0,644745325596389;0,869565217391304
"84";2020-05-22;2808;209;2284;1;8;0;36;8;408;0;430;2;0;3;1;6;12;0;1;1;315;838;0,00954653937947494;0,65994959530697;0,773694390715667;0,869565217391304
"85";2020-05-23;2810;209;2315;1;2;0;31;8;0;0;694;2;0;3;1;5;11;0;1;1;286;694;0,00288184438040346;0,630513952541728;0,709219858156028;0,869565217391304
"86";2020-05-24;2810;209;2326;1;0;0;11;8;32;0;181;1;0;3;1;5;10;0;1;1;275;213;0;0,555979791051045;0,644745325596389;0,869565217391304
"87";2020-05-25;2817;209;2367;1;7;0;41;7;565;0;627;2;0;3;1;6;12;0;1;1;241;1192;0,00587248322147651;0,523373209432703;0,773694390715667;0,869565217391304
"88";2020-05-26;2820;209;2386;1;3;0;19;7;181;0;541;2;0;2;1;1;6;0;1;1;225;722;0,00415512465373961;0,515788767145117;0,386847195357834;0,869565217391304
"89";2020-05-27;2834;209;2425;1;14;0;39;8;252;0;887;3;0;1;1;1;6;0;1;1;200;1139;0,0122914837576822;0,555326970486155;0,386847195357834;0,869565217391304
"90";2020-05-28;2838;209;2459;1;4;0;34;7;513;0;718;4;0;1;1;2;8;0;1;1;170;1231;0,00324939073923639;0,542812373314473;0,515796260477112;0,869565217391304
"91";2020-05-29;2846;209;2515;1;8;0;56;7;646;0;754;4;0;1;1;2;8;0;1;1;122;1400;0,00571428571428571;0,488065892383198;0,515796260477112;0,869565217391304
"92";2020-05-30;2848;209;2553;1;2;0;38;7;1;0;528;4;0;1;1;2;8;0;1;1;86;529;0,00378071833648393;0,500906948898633;0,515796260477112;0,869565217391304
"93";2020-05-31;2850;209;2555;1;2;0;2;6;7;0;144;4;0;1;1;3;9;0;1;1;86;151;0,0132450331125828;0,690121707649816;0,58027079303675;0,869565217391304
"94";2020-06-01;2854;209;2563;1;4;0;8;6;40;0;328;4;0;2;1;3;10;0;1;1;82;368;0,0108695652173913;0,761508593305742;0,644745325596389;0,869565217391304
"95";2020-06-02;2862;209;2575;1;8;0;12;6;174;0;740;3;0;1;0;4;8;0;1;1;78;914;0,0087527352297593;0,827188744391737;0,515796260477112;0,869565217391304
"96";2020-06-03;2866;209;2584;1;4;0;9;6;457;0;767;4;0;1;0;4;9;0;1;1;73;1224;0,00326797385620915;0,69828146008498;0,58027079303675;0,869565217391304
"97";2020-06-04;2872;209;2604;1;6;0;20;6;370;0;766;4;0;0;0;1;5;0;1;1;59;1136;0,00528169014084507;0,727314308679389;0,322372662798195;0,869565217391304
"98";2020-06-05;2877;209;2609;1;5;0;5;5;190;0;942;4;0;0;0;2;6;0;1;1;59;1132;0,00441696113074205;0,708781100343051;0,386847195357834;0,869565217391304
"99";2020-06-06;2877;209;2613;1;0;0;4;5;0;0;508;4;0;0;0;2;6;0;1;1;55;508;0;0,654770838393281;0,386847195357834;0,869565217391304
"100";2020-06-07;2879;209;2614;2;2;0;1;5;17;0;140;4;0;0;0;3;7;0;2;2;56;157;0,0127388535031847;0,647539701116166;0,451321727917473;1,73913043478261
"101";2020-06-08;2887;209;2617;2;8;0;3;5;325;0;465;4;0;1;0;3;8;0;2;2;61;790;0,010126582278481;0,636925659131733;0,515796260477112;1,73913043478261
"102";2020-06-09;2889;209;2628;2;2;0;11;4;407;0;462;3;0;1;0;4;8;0;2;2;52;869;0,00230149597238205;0,544765098312058;0,515796260477112;1,73913043478261
"103";2020-06-10;2894;209;2640;2;5;0;12;4;226;0;791;2;0;1;0;3;6;0;2;2;45;1017;0,00491642084562439;0,56831434101799;0,386847195357834;1,73913043478261
"104";2020-06-11;2899;209;2647;1;5;0;7;4;433;0;670;2;0;0;1;2;5;0;1;1;43;1103;0,00453309156844968;0,557620075698056;0,322372662798195;0,869565217391304
"105";2020-06-12;2909;209;2656;0;10;0;9;4;551;0;695;1;0;0;1;3;5;0;0;0;44;1246;0,00802568218298555;0,609173233587249;0,322372662798195;0
"106";2020-06-13;2911;209;2659;0;2;0;3;4;3;0;763;1;0;0;1;4;6;0;0;0;43;766;0,00261096605744125;0,646472748693552;0,386847195357834;0
"107";2020-06-14;2912;209;2660;0;1;0;1;4;184;0;235;1;0;0;1;4;6;0;0;0;43;419;0,00238663484486874;0,49858391071761;0,386847195357834;0
"108";2020-06-15;2919;209;2655;0;7;0;-5;4;323;0;412;1;0;0;1;4;6;0;0;0;55;735;0,00952380952380952;0,48997287136516;0,386847195357834;0
"109";2020-06-16;2923;209;2668;0;4;0;13;4;41;0;817;0;0;0;2;4;6;0;0;0;46;858;0,00466200466200466;0,523694424074054;0,386847195357834;0
"110";2020-06-17;2937;209;2684;0;14;0;16;4;309;0;706;0;0;0;0;4;4;0;0;0;44;1015;0,0137931034482759;0,650504175540504;0,257898130238556;0
"111";2020-06-18;2952;209;2704;0;15;0;20;3;503;0;914;0;0;0;0;3;3;0;0;0;39;1417;0,0105857445306987;0,736970646429775;0,193423597678917;0
"112";2020-06-19;2964;209;2718;0;12;0;14;3;119;0;875;0;0;0;0;3;3;0;0;0;37;994;0,0120724346076459;0,794781395353494;0,193423597678917;0
"113";2020-06-20;2965;209;2720;0;1;0;2;4;0;0;592;0;0;0;0;4;4;0;0;0;36;592;0,00168918918918919;0,781613154378464;0,257898130238556;0
"114";2020-06-21;2971;209;2723;0;6;0;3;4;191;0;305;0;0;0;0;4;4;0;0;0;39;496;0,0120967741935484;0,920329430788174;0,257898130238556;0
"115";2020-06-22;2983;209;2732;0;12;0;9;4;79;0;164;0;0;1;0;3;4;0;0;0;42;243;0,0493827160493827;1,4897423811535;0,257898130238556;0
"116";2020-06-23;2990;209;2742;0;7;0;10;4;119;0;975;1;0;2;0;3;6;0;0;0;39;1094;0,00639853747714808;1,51454999279841;0,386847195357834;0
"117";2020-06-24;3017;209;2771;0;27;0;29;4;157;0;974;0;0;1;0;4;5;0;0;0;37;1131;0,0238726790450928;1,6585439298958;0,322372662798195;0
"118";2020-06-25;3025;209;2791;0;8;0;20;4;87;0;845;0;0;1;0;1;2;0;0;0;25;932;0,00858369098712446;1,62994316498759;0,128949065119278;0
"119";2020-06-26;3036;209;2800;0;11;0;9;4;76;0;720;0;0;1;0;1;2;0;0;0;27;796;0,0138190954773869;1,65489546312675;0,128949065119278;0
"120";2020-06-27;3042;209;2803;0;6;0;3;4;3;0;894;0;0;0;0;2;2;0;0;0;30;897;0,00668896321070234;1,72632080629122;0,128949065119278;0
"121";2020-06-28;3042;209;2803;0;0;0;0;4;0;0;405;0;0;0;0;2;2;0;0;0;30;405;0;1,55350974638339;0,128949065119278;0
"122";2020-06-29;3048;209;2809;0;6;0;6;4;80;0;414;0;0;0;0;3;3;0;0;0;30;494;0,0121457489878543;1,02155307407584;0,193423597678917;0
"123";2020-06-30;3061;211;2819;0;13;2;10;4;59;0;816;0;0;0;0;2;2;0;0;0;31;875;0,0148571428571429;1,14239029379005;0,128949065119278;0
"124";2020-07-01;3068;211;2827;0;7;0;8;4;131;0;1058;0;0;0;0;2;2;0;0;0;30;1189;0,00588730025231287;0,885456311036053;0,128949065119278;0
"125";2020-07-02;3075;211;2834;0;7;0;7;4;75;0;749;0;0;0;0;1;1;0;0;0;30;824;0,00849514563106796;0,884191377378103;0,0644745325596389;0
"126";2020-07-03;3083;211;2843;0;8;0;9;4;47;0;635;0;0;0;0;1;1;0;0;0;29;682;0,0117302052785924;0,854350088823895;0,0644745325596389;0
"127";2020-07-04;3084;211;2844;0;1;0;1;4;0;0;675;0;0;0;0;1;1;0;0;0;29;675;0,00148148148148148;0,779957492692168;0,0644745325596389;0
"128";2020-07-05;3084;211;2844;0;0;0;0;3;0;0;181;0;0;0;0;1;1;0;0;0;29;181;0;0,779957492692168;0,0644745325596389;0
"129";2020-07-06;3088;211;2847;0;4;0;3;3;73;0;266;0;0;0;0;1;1;0;0;0;30;339;0,0117994100294985;0,775009793287087;0,0644745325596389;0
"130";2020-07-07;3093;211;2849;0;5;0;2;3;66;0;783;0;0;0;0;1;1;0;0;0;33;849;0,00588928150765607;0,646897488294418;0,0644745325596389;0
"131";2020-07-08;3104;211;2864;0;11;0;15;3;114;0;661;0;0;0;0;1;1;0;0;0;29;775;0,0141935483870968;0,765558175934188;0,0644745325596389;0
"132";2020-07-09;3108;211;2874;0;4;0;10;3;68;0;830;0;0;0;0;1;1;0;0;0;23;898;0,0044543429844098;0,707832423839072;0,0644745325596389;0
"133";2020-07-10;3111;211;2876;0;3;0;2;3;86;0;565;0;0;0;0;1;1;0;0;0;24;651;0,00460829493087558;0,606090847443117;0,0644745325596389;0
"134";2020-07-11;3111;211;2876;0;0;0;0;2;0;0;390;0;0;0;0;1;1;0;0;0;24;390;0;0,584926826279096;0,0644745325596389;0
"135";2020-07-12;3114;211;2876;0;3;0;0;2;0;0;349;0;0;0;0;1;1;0;0;0;27;349;0,00859598853868195;0,707726662545981;0,0644745325596389;0
"136";2020-07-13;3116;211;2877;0;2;0;1;2;67;0;310;0;0;2;0;1;3;0;0;0;28;377;0,00530503978779841;0,614949944807408;0,193423597678917;0
"137";2020-07-14;3123;211;2883;0;7;0;6;3;70;0;686;0;0;1;0;1;2;0;0;0;29;756;0,00925925925925926;0,663092484116025;0,128949065119278;0
"138";2020-07-15;3132;211;2893;0;9;0;10;3;65;0;576;0;0;1;0;2;3;0;0;0;28;641;0,0140405616224649;0,660906958906998;0,193423597678917;0
"139";2020-07-16;3136;212;2896;0;4;1;3;3;21;0;943;0;0;0;0;2;2;0;0;0;28;964;0,004149377593361;0,656550310463444;0,128949065119278;0
"140";2020-07-17;3143;212;2902;0;7;0;6;3;92;0;476;0;0;0;0;1;1;0;0;0;29;568;0,0123239436619718;0,766773863764819;0,0644745325596389;0
"141";2020-07-18;3151;212;2901;0;8;0;-1;4;0;0;555;0;0;1;0;1;2;0;0;0;38;555;0,0144144144144144;0,972694069685025;0,128949065119278;0
"142";2020-07-19;3172;212;2910;0;21;0;9;6;35;0;373;0;0;1;0;1;2;0;0;0;50;408;0,0514705882352941;1,5851883510652;0,128949065119278;0
"143";2020-07-20;3185;212;2923;0;13;0;13;7;65;0;760;0;0;0;0;1;1;0;0;0;50;825;0,0157575757575758;1,73451029349059;0,0644745325596389;0
"144";2020-07-21;3187;212;2923;1;2;0;0;7;33;0;469;0;0;0;0;2;2;0;1;1;52;502;0,00398406374501992;1,65915035757288;0,128949065119278;0,869565217391304
"145";2020-07-22;3195;212;2929;1;8;0;6;7;72;0;973;0;0;0;0;1;1;0;1;1;54;1045;0,0076555023923445;1,56793522571402;0,0644745325596389;0,869565217391304
"146";2020-07-23;3209;212;2935;1;14;0;6;9;71;0;802;0;0;0;0;2;2;0;1;1;62;873;0,0160366552119129;1,73775347740762;0,128949065119278;0,869565217391304
"147";2020-07-24;3221;212;2942;1;12;0;7;9;82;0;383;0;0;0;0;1;1;0;1;1;67;465;0,0258064516129032;1,9303607338495;0,0644745325596389;0,869565217391304
"148";2020-07-25;3227;212;2943;1;6;0;1;10;0;0;614;0;0;0;0;1;1;0;1;1;72;614;0,00977198697068404;1,86404034179621;0,0644745325596389;0,869565217391304
"149";2020-07-26;3232;212;2944;1;5;0;1;11;10;0;396;0;0;0;0;1;1;0;1;1;76;406;0,0123152709359606;1,30467866609144;0,0644745325596389;0,869565217391304
"150";2020-07-27;3245;212;2949;1;13;0;5;12;36;0;600;0;0;0;0;2;2;0;1;1;84;636;0,020440251572327;1,3715740348736;0,128949065119278;0,869565217391304
"151";2020-07-28;3246;212;2951;1;1;0;2;12;0;0;657;0;0;0;0;2;2;0;1;1;83;657;0,0015220700152207;1,33640269587647;0,128949065119278;0,869565217391304
"152";2020-07-29;3240;212;2937;1;-6;0;-14;13;38;0;772;0;0;0;0;2;2;0;1;1;91;810;-0,00740740740740741;1,12121827016573;0,128949065119278;0,869565217391304
"153";2020-07-30;3278;212;2963;1;38;0;26;15;27;0;901;0;0;1;0;6;7;0;1;1;103;928;0,040948275862069;1,47709856516796;0,451321727917473;0,869565217391304
"154";2020-07-31;3298;212;2969;0;20;0;6;18;64;0;682;0;0;1;0;6;7;0;0;0;117;746;0,0268096514745308;1,49142999176264;0,451321727917473;0
"155";2020-08-01;3322;212;2973;1;24;0;4;20;2;0;631;0;0;1;0;9;10;0;1;1;137;633;0,037914691943128;1,89346863422612;0,644745325596389;0,869565217391304
"156";2020-08-02;3343;212;2973;0;21;0;0;22;0;0;585;0;0;2;0;11;13;0;0;0;158;585;0,0358974358974359;2,23035670510434;0,838168923275306;0
"157";2020-08-03;3384;212;2979;1;41;0;6;28;64;0;918;0;0;2;0;12;14;0;1;1;193;982;0,0417515274949083;2,53480350399836;0,902643455834945;0,869565217391304
"158";2020-08-04;3423;212;2986;1;39;0;7;34;77;0;1131;0;0;2;0;13;15;0;1;1;225;1208;0,0322847682119205;2,97427062109407;0,967117988394584;0,869565217391304
"159";2020-08-05;3444;212;2992;1;21;0;6;37;53;0;968;0;0;2;0;13;15;0;1;1;240;1021;0,0205680705190989;3,37392030575845;0,967117988394584;0,869565217391304
"160";2020-08-06;3486;212;3005;0;42;0;13;40;113;0;1101;0;0;3;0;13;16;0;0;0;269;1214;0,0345963756177924;3,28317887369736;1,03159252095422;0
"161";2020-08-07;3519;213;3017;0;33;1;12;45;59;0;1045;0;0;3;0;13;16;0;0;0;289;1104;0,0298913043478261;3,327202486173;1,03159252095422;0
"162";2020-08-08;3550;213;3027;0;31;0;10;49;0;0;940;0;0;4;0;12;16;0;0;0;310;940;0,0329787234042553;3,25668864990339;1,03159252095422;0
"163";2020-08-09;3580;213;3030;0;30;0;3;53;0;0;469;0;0;4;0;12;16;0;0;0;337;469;0,0639658848614073;3,65766649224584;1,03159252095422;0
"164";2020-08-10;3597;214;3039;0;17;1;9;54;61;0;704;0;0;5;0;11;16;0;0;0;344;765;0,0222222222222222;3,37867641692175;1,03159252095422;0
"165";2020-08-11;3663;215;3047;0;66;1;8;65;39;0;1524;0;0;3;0;11;14;0;0;0;401;1563;0,0422264875239923;3,52070097852278;0,902643455834945;0
"166";2020-08-12;3710;215;3059;0;47;0;12;71;84;0;1465;0;0;3;0;12;15;0;0;0;436;1549;0,0303421562298257;3,6603307743903;0,967117988394584;0
"167";2020-08-13;3774;215;3079;0;64;0;20;79;31;0;1141;0;0;1;0;15;16;0;0;0;480;1172;0,0546075085324232;3,94620410174217;1,03159252095422;0
"168";2020-08-14;3858;215;3096;0;84;0;17;89;72;0;1259;0;0;0;0;22;22;0;0;0;547;1331;0,0631104432757325;4,42076322928369;1,41843971631206;0
"169";2020-08-15;3921;215;3110;0;63;0;14;95;0;0;1350;0;0;1;0;25;26;0;0;0;596;1350;0,0466666666666667;4,61630527588957;1,67633784655061;0
"170";2020-08-16;3963;215;3118;1;42;0;8;100;0;0;888;0;0;1;0;23;24;0;1;1;630;888;0,0472972972972973;4,37818259640228;1,54738878143133;0,869565217391304
"171";2020-08-17;3982;215;3125;1;19;0;7;97;31;0;792;0;0;1;0;21;22;0;1;1;642;823;0,023086269744836;4,39052613243962;1,41843971631206;0,869565217391304
"172";2020-08-18;4033;215;3158;2;51;0;33;100;100;0;1603;1;0;2;0;20;23;0;2;2;660;1703;0,0299471520845567;4,2151070547334;1,4829142488717;1,73913043478261
"173";2020-08-19;4083;216;3184;2;50;1;26;105;48;0;1571;1;0;2;0;23;26;0;2;2;683;1619;0,0308832612723904;4,22283712677004;1,67633784655061;1,73913043478261
"174";2020-08-20;4151;216;3217;3;68;0;33;113;69;0;1283;2;0;1;0;25;28;0;3;3;718;1352;0,0502958579881657;4,16124211899493;1,80528691166989;2,60869565217391
"175";2020-08-21;4254;216;3269;3;103;0;52;123;58;0;1816;3;0;3;1;29;36;0;3;3;769;1874;0,0549626467449306;4,04484502569776;2,321083172147;2,60869565217391
"176";2020-08-22;4329;216;3311;3;75;0;42;130;0;0;1417;3;0;3;1;24;31;0;3;3;802;1417;0,0529287226534933;4,13430296836671;1,99871050934881;2,60869565217391
"177";2020-08-23;4366;216;3337;2;37;0;26;131;0;0;941;3;0;4;1;22;30;0;2;2;813;941;0,0393198724760893;4,02033975663517;1,93423597678917;1,73913043478261
"178";2020-08-24;4420;216;3365;1;54;0;28;138;51;0;1167;2;0;2;1;24;29;0;1;1;839;1218;0,0443349753694581;4,32389269412977;1,86976144422953;0,869565217391304
"179";2020-08-25;4505;216;3462;0;85;0;97;141;75;0;1941;2;0;4;1;21;28;0;0;0;827;2016;0,0421626984126984;4,49840049881751;1,80528691166989;0
"180";2020-08-26;4597;216;3521;1;92;0;59;149;68;0;1619;2;0;4;1;22;29;0;1;1;860;1687;0,0545346769413159;4,83627786551645;1,86976144422953;0,869565217391304
"181";2020-08-27;4691;216;3571;2;94;0;50;154;57;0;1775;3;0;5;1;18;27;0;2;2;904;1832;0,0513100436681223;4,85076623237297;1,74081237911025;1,73913043478261
"182";2020-08-28;4820;216;3637;1;129;0;66;162;77;0;1859;4;0;7;1;17;29;0;1;1;967;1936;0,0666322314049587;5,01747458465909;1,86976144422953;0,869565217391304
"183";2020-08-29;4934;218;3689;1;114;2;52;171;0;0;1622;4;0;7;1;19;31;0;1;1;1027;1622;0,0702836004932182;5,26540141094087;1,99871050934881;0,869565217391304
"184";2020-08-30;5001;218;3700;1;67;0;11;175;7;0;682;6;0;6;1;21;34;0;1;1;1083;689;0,0972423802612482;6,09286580787171;2,19213410702772;0,869565217391304
"185";2020-08-31;5066;219;3723;4;65;1;23;182;56;0;960;5;0;7;0;25;37;0;4;4;1124;1016;0,0639763779527559;6,3734572733474;2,38555770470664;3,47826086956522
"186";2020-09-01;5182;219;3812;5;116;0;89;193;55;0;1595;8;0;8;0;31;47;0;5;5;1151;1650;0,0703030303030303;6,77546201463785;3,03030303030303;4,34782608695652
"187";2020-09-02;5284;220;3863;4;102;1;51;202;13;0;1731;7;0;8;0;28;43;0;4;4;1201;1744;0,0584862385321101;6,83191289450634;2,77240490006447;3,47826086956522
"188";2020-09-03;5429;220;3925;4;145;0;62;212;111;0;1616;10;0;7;0;28;45;0;4;4;1284;1727;0,0839606253618992;7,29834977584601;2,90135396518375;3,47826086956522
"189";2020-09-04;5557;221;4000;6;128;1;75;216;35;0;1749;7;0;7;0;28;42;0;6;6;1336;1784;0,0717488789237668;7,37144474040041;2,70793036750484;5,21739130434783
"190";2020-09-05;5676;221;4066;8;119;0;66;223;13;0;1354;8;0;8;0;34;50;0;8;8;1389;1367;0,0870519385515728;7,61099242694833;3,22372662798195;6,95652173913043
"191";2020-09-06;5736;221;4106;8;60;0;40;227;0;0;805;8;0;8;0;38;54;0;8;8;1409;805;0,0745341614906832;7,28658930165455;3,4816247582205;6,95652173913043
"192";2020-09-07;5819;222;4169;9;83;1;63;232;82;0;1180;6;0;10;0;33;49;0;9;9;1428;1262;0,0657686212361331;7,31219277713137;3,15925209542231;7,82608695652174
"193";2020-09-08;5926;222;4271;9;107;0;102;236;29;0;1361;6;0;7;1;29;43;0;9;9;1433;1390;0,0769784172661871;7,40755544803361;2,77240490006447;7,82608695652174
"194";2020-09-09;6105;223;4364;9;179;1;93;251;45;0;1849;6;0;11;1;38;56;0;9;9;1518;1894;0,0945089757127772;7,92216597918599;3,61057382333978;7,82608695652174
"195";2020-09-10;6257;223;4466;7;152;0;102;261;71;0;1736;7;0;12;2;37;58;0;7;7;1568;1807;0,0841173215273935;7,92440449583591;3,73952288845906;6,08695652173913
"196";2020-09-11;6372;223;4586;5;115;0;120;259;24;0;1439;5;0;11;2;35;53;0;5;5;1563;1463;0,0786056049213944;8,02235772437345;3,41715022566086;4,34782608695652
"197";2020-09-12;6494;223;4633;7;122;0;47;259;51;0;1451;6;0;13;4;42;65;0;7;7;1638;1502;0,0812250332889481;7,93911622062167;4,19084461637653;6,08695652173913
"198";2020-09-13;6603;223;4660;8;109;0;27;265;53;0;1332;8;0;16;4;45;73;0;8;8;1720;1385;0,0787003610108303;7,99863335662377;4,70664087685364;6,95652173913043
"199";2020-09-14;6688;223;4726;8;85;0;66;267;23;0;1633;7;0;15;4;41;67;0;8;8;1739;1656;0,0513285024154589;7,79234594489985;4,31979368149581;6,95652173913043
"200";2020-09-15;6768;224;4785;7;80;1;59;261;1;0;1512;8;0;17;3;41;69;0;7;7;1759;1513;0,0528750826173166;7,44801259277313;4,44874274661509;6,08695652173913
"201";2020-09-16;6888;224;4874;10;120;0;89;263;52;0;2083;7;0;17;3;40;67;0;10;10;1790;2135;0,0562060889929742;6,90082849677594;4,31979368149581;8,69565217391304
"202";2020-09-17;6952;225;4908;10;64;1;34;249;121;0;1491;5;0;16;3;41;65;0;10;10;1819;1612;0,0397022332506203;6,26632723567918;4,19084461637653;8,69565217391304
"203";2020-09-18;7061;228;4973;11;109;3;65;247;62;0;1744;5;0;15;2;44;66;0;11;11;1860;1806;0,0603543743078627;6,00559536977159;4,25531914893617;9,56521739130435
"204";2020-09-19;7138;229;5038;10;77;1;65;237;1;0;1441;6;0;15;2;49;72;0;10;10;1871;1442;0,0533980582524272;5,60806715496415;4,642166344294;8,69565217391304
"205";2020-09-20;7194;229;5078;10;56;0;40;235;0;0;721;9;0;16;2;49;76;0;10;10;1887;721;0,0776699029126214;5,59334632498973;4,90006447453256;8,69565217391304
"206";2020-09-21;7262;229;5107;9;68;0;29;229;67;0;1007;9;0;11;1;54;75;0;9;9;1926;1074;0,0633147113594041;5,76457788133181;4,83558994197292;7,82608695652174
"207";2020-09-22;7334;229;5186;9;72;0;79;222;68;0;1558;9;0;8;0;52;69;0;9;9;1919;1626;0,044280442804428;5,64179731257626;4,44874274661509;7,82608695652174
"208";2020-09-23;7395;229;5230;8;61;0;44;202;77;0;1569;7;0;8;1;42;58;0;8;8;1936;1646;0,0370595382746051;5,3682751594567;3,73952288845906;6,95652173913043
"209";2020-09-24;7452;230;5314;6;57;1;84;185;129;0;1200;7;0;8;1;45;61;0;6;6;1908;1329;0,0428893905191874;5,41380597757908;3,93294648613798;5,21739130434783
"210";2020-09-25;7527;230;5397;7;75;0;83;174;56;0;1741;7;0;9;1;40;57;0;7;7;1900;1797;0,0417362270450751;5,14783244525355;3,67504835589942;6,08695652173913
"211";2020-09-26;7582;231;5496;8;55;1;99;164;0;0;1337;8;0;10;1;40;59;0;8;8;1855;1337;0,0411368735976066;4,97267266447039;3,8039974210187;6,95652173913043
"212";2020-09-27;7607;231;5541;8;25;0;45;151;52;0;627;8;0;9;1;38;56;0;8;8;1835;679;0,0368188512518409;4,38908621217353;3,61057382333978;6,95652173913043
"213";2020-09-28;7682;232;5595;9;75;1;54;150;108;0;1495;4;0;9;2;40;55;0;9;9;1855;1603;0,0467872738615097;4,15297996220361;3,54609929078014;7,82608695652174
"214";2020-09-29;7716;232;5629;11;34;0;34;143;49;0;1085;4;0;7;2;42;55;0;11;11;1855;1134;0,0299823633156966;3,94872168379316;3,54609929078014;9,56521739130435
"215";2020-09-30;7762;232;5664;10;46;0;35;131;78;0;1302;6;0;7;2;37;52;0;10;10;1866;1380;0,0333333333333333;3,89549018463214;3,35267569310122;8,69565217391304
"216";2020-10-01;7808;232;5722;9;46;0;58;128;141;0;1508;5;0;8;3;37;53;0;9;9;1854;1649;0,0278956943602183;3,68129452521829;3,41715022566086;7,82608695652174
"217";2020-10-02;7874;233;5737;11;66;1;15;121;57;0;1494;4;0;6;1;33;44;0;11;11;1904;1551;0,0425531914893617;3,69296544585096;2,83687943262411;9,56521739130435
"218";2020-10-03;7906;233;5845;11;32;0;108;117;0;0;1135;4;0;6;2;31;43;0;11;11;1828;1135;0,0281938325991189;3,50806486015828;2,77240490006447;9,56521739130435
"219";2020-10-04;7967;234;5870;11;61;1;25;119;2;0;966;3;0;5;2;33;43;0;11;11;1863;968;0,0630165289256198;3,88231739835512;2,77240490006447;9,56521739130435
"220";2020-10-05;8008;234;5945;6;41;0;75;117;56;0;834;1;0;3;2;37;43;0;6;6;1829;890;0,0460674157303371;3,87203371076694;2,77240490006447;5,21739130434783
"221";2020-10-06;8054;234;5988;8;46;0;43;114;68;0;1087;1;0;2;2;37;42;0;8;8;1832;1155;0,0398268398268398;4,01266908949756;2,70793036750484;6,95652173913043
"222";2020-10-07;8093;234;6203;7;39;0;215;110;56;0;1425;0;0;4;1;33;38;0;7;7;1656;1481;0,0263335584064821;3,91267230482825;2,45003223726628;6,08695652173913
"223";2020-10-08;8126;234;6298;6;33;0;95;107;60;0;1563;0;0;5;1;33;39;0;6;6;1594;1623;0,0203327171903882;3,80462977383068;2,51450676982592;5,21739130434783
"224";2020-10-09;8194;235;6465;6;68;1;167;110;56;0;1918;3;0;4;0;28;35;0;6;6;1494;1974;0,0344478216818642;3,68883877658072;2,25660863958736;5,21739130434783
"225";2020-10-10;8264;236;6562;6;70;1;97;112;0;0;1394;2;0;3;0;28;33;0;6;6;1466;1394;0,0502152080344333;4,00342985422806;2,12765957446809;5,21739130434783
"226";2020-10-11;8299;236;6573;8;35;0;11;114;0;0;486;3;0;3;0;31;37;0;8;8;1490;486;0,0720164609053498;4,13200031108135;2,38555770470664;6,95652173913043
"227";2020-10-12;8344;236;6692;10;45;0;119;109;0;0;658;4;0;3;1;34;42;0;10;10;1416;658;0,0683890577507599;4,4508809113731;2,70793036750484;8,69565217391304
"228";2020-10-13;8417;237;6851;9;73;1;159;116;45;0;980;4;0;4;1;32;41;0;9;9;1329;1025;0,0712195121951219;4,89934765949142;2,6434558349452;7,82608695652174
"229";2020-10-14;8478;237;6930;10;61;0;79;118;82;0;1247;4;0;3;1;30;38;0;10;10;1311;1329;0,0458991723100075;5,17885642954178;2,45003223726628;8,69565217391304
"230";2020-10-15;8563;239;7231;9;85;2;301;126;40;0;1650;6;0;2;1;27;36;0;9;9;1093;1690;0,0502958579881657;5,60690129808146;2,321083172147;7,82608695652174
"231";2020-10-16;8665;241;7403;8;102;2;172;132;73;0;1545;5;0;5;1;23;34;0;8;8;1021;1618;0,0630407911001236;6,01537228977088;2,19213410702772;6,95652173913043
"232";2020-10-17;8820;244;7570;8;155;3;167;154;0;0;1174;6;0;8;1;25;40;0;8;8;1006;1174;0,132027257240204;7,18411584985333;2,57898130238556;6,95652173913043
"233";2020-10-18;8868;244;7581;9;48;0;11;151;0;0;754;6;0;11;2;32;51;0;9;9;1043;754;0,0636604774535809;7,0647446576852;3,28820116054159;7,82608695652174
"234";2020-10-19;8961;244;7658;10;93;0;77;161;32;0;1450;3;0;13;2;40;58;0;10;10;1059;1482;0,062753036437247;6,98423006749216;3,73952288845906;8,69565217391304
"235";2020-10-20;9120;244;7703;12;159;0;45;180;57;0;1379;4;0;14;2;38;58;0;12;12;1173;1436;0,110724233983287;7,54858323589451;3,73952288845906;10,4347826086957
"236";2020-10-21;9334;245;7750;11;214;1;47;211;31;0;2332;5;0;11;2;38;56;0;11;11;1339;2363;0,090562843842573;8,18663568635973;3,61057382333978;9,56521739130435
"237";2020-10-22;9452;245;7773;11;118;0;23;225;39;0;1444;5;0;12;3;38;58;0;11;11;1434;1483;0,0795684423465947;8,60481546290872;3,73952288845906;9,56521739130435
"238";2020-10-23;9637;245;7906;11;185;0;133;245;67;0;1830;6;0;13;4;44;67;0;11;11;1486;1897;0,0975224037954665;9,09740992998505;4,31979368149581;9,56521739130435
"239";2020-10-24;9811;245;7928;12;174;0;22;263;0;0;1923;6;0;15;4;47;72;0;12;12;1638;1923;0,0904836193447738;8,50392938862175;4,642166344294;10,4347826086957
"240";2020-10-25;9975;245;8119;13;164;0;191;285;0;0;1212;7;0;18;4;49;78;0;13;13;1611;1212;0,135313531353135;9,52754444432967;5,02901353965184;11,304347826087
"241";2020-10-26;10110;247;8157;14;135;2;38;300;68;0;1638;9;0;15;2;59;85;0;14;14;1706;1706;0,0791324736225088;9,76153640411913;5,48033526756931;12,1739130434783
"242";2020-10-27;10283;248;8236;16;173;1;79;317;71;0;1759;11;0;20;6;63;100;0;16;16;1799;1830;0,0945355191256831;9,5302690490105;6,44745325596389;13,9130434782609
"243";2020-10-28;10484;249;8363;12;201;1;127;341;51;0;1902;13;0;26;7;64;110;0;12;12;1872;1953;0,102918586789555;9,70677966253881;7,09219858156028;10,4347826086957
"244";2020-10-29;10666;249;8416;12;182;0;53;358;102;0;1712;15;0;23;8;67;113;0;12;12;2001;1814;0,100330760749724;10,0033842111549;7,2856221792392;10,4347826086957
"245";2020-10-30;10834;250;8557;12;168;1;141;369;77;0;1787;16;0;25;3;78;122;0;12;12;2027;1864;0,0901287553648069;9,89776066214552;7,86589297227595;10,4347826086957
"246";2020-10-31;11030;252;8577;15;196;2;20;376;0;0;1555;16;0;24;3;92;135;0;15;15;2201;1555;0,12604501607717;10,4057806154655;8,70406189555126;13,0434782608696
"247";2020-11-01;11175;252;8620;16;145;0;43;393;0;0;1096;19;0;27;3;98;147;0;16;16;2303;1096;0,132299270072993;10,3627197400349;9,47775628626692;13,9130434782609
"248";2020-11-02;11391;252;8750;17;216;0;130;414;0;0;1591;19;0;27;7;104;157;0;17;17;2389;1591;0,135763670647392;11,1717368403903;10,1225016118633;14,7826086956522
"249";2020-11-03;11628;256;8871;17;237;4;121;428;83;0;2062;15;0;25;5;104;149;0;17;17;2501;2145;0,11048951048951;11,3996510027307;9,6067053513862;14,7826086956522
"250";2020-11-04;11785;260;9121;19;157;4;250;418;71;0;1428;15;0;23;3;107;148;0;19;19;2404;1499;0,104736490993996;11,4256210627942;9,54223081882656;16,5217391304348
"251";2020-11-05;12095;261;9235;21;310;1;114;451;91;0;2676;14;0;22;3;109;148;0;21;21;2599;2767;0,112034694615107;11,5928201180139;9,54223081882656;18,2608695652174
"252";2020-11-06;12322;263;9255;23;227;2;20;458;79;0;1999;17;0;25;3;113;158;0;23;23;2804;2078;0,109239653512993;11,8658329487023;10,186976144423;20
"253";2020-11-07;12502;265;9439;24;180;2;184;459;0;0;1712;17;0;26;4;110;157;0;24;24;2798;1712;0,105140186915888;11,5671925321125;10,1225016118633;20,8695652173913
"254";2020-11-08;12738;267;9607;29;236;2;168;471;0;0;1333;17;0;29;4;127;177;0;29;29;2864;1333;0,177044261065266;12,206406689145;11,4119922630561;25,2173913043478
"255";2020-11-09;12964;269;9757;34;226;2;150;487;84;0;2077;21;0;25;4;129;179;0;34;34;2938;2161;0,104581212401666;11,7609429999204;11,5409413281754;29,5652173913043
"256";2020-11-10;13220;272;9792;35;256;3;35;500;64;0;2147;23;0;29;4;136;192;0;35;35;3156;2211;0,115784712799638;11,8365887472079;12,3791102514507;30,4347826086957
"257";2020-11-11;13480;273;9896;34;260;1;104;511;90;0;2160;21;0;33;4;139;197;0;34;34;3311;2250;0,115555555555556;11,9911468123731;12,7014829142489;29,5652173913043
"258";2020-11-12;13708;278;9939;35;228;5;43;519;63;0;2138;19;0;38;4;135;196;0;35;35;3491;2201;0,10358927760109;11,8704979978871;12,6370083816892;30,4347826086957
"259";2020-11-13;13917;281;10007;34;209;3;68;525;95;0;2062;16;0;32;3;127;178;0;34;34;3629;2157;0,0968938340287436;11,6941291481121;11,4764667956157;29,5652173913043
"260";2020-11-14;14110;281;10200;34;193;0;193;525;0;0;1945;16;0;37;4;134;191;0;34;34;3629;1945;0,0992287917737789;11,609680646082;12,314635718891;29,5652173913043
"261";2020-11-15;14240;282;10333;32;130;1;133;522;0;0;1181;14;0;39;4;140;197;0;32;32;3625;1181;0,110076206604572;10,6529941537864;12,7014829142489;27,8260869565217
"262";2020-11-16;14481;285;10411;30;241;3;78;526;83;0;2039;16;0;37;5;131;189;0;30;30;3785;2122;0,113572101790763;10,7814354307735;12,1856866537718;26,0869565217391
"263";2020-11-17;14761;291;10506;35;280;6;95;533;93;0;3005;17;0;40;6;136;199;0;35;35;3964;3098;0,0903808908973531;10,4185236893122;12,8304319793682;30,4347826086957
"264";2020-11-18;15001;292;10588;33;240;1;82;547;88;0;2473;19;0;41;6;127;193;0;33;33;4121;2561;0,093713393205779;10,1064927986012;12,4435847840103;28,695652173913
"265";2020-11-19;15168;293;10812;36;167;1;224;522;126;0;2013;21;0;40;6;119;186;0;36;36;4063;2139;0,0780738662926601;9,74198692276644;11,9922630560928;31,304347826087
"266";2020-11-20;15338;295;10865;38;170;2;53;512;103;0;2083;17;0;34;7;121;179;0;38;38;4178;2186;0,0777676120768527;9,46875518059657;11,5409413281754;33,0434782608696
"267";2020-11-21;15489;296;10908;36;151;1;43;507;0;0;1802;17;0;37;7;121;182;0;36;36;4285;1802;0,083795782463929;9,24828361902728;11,7343649258543;31,304347826087
"268";2020-11-22;15573;297;11062;38;84;1;154;481;0;0;934;15;0;40;6;121;182;0;38;38;4214;934;0,0899357601713062;8,96056295569491;11,7343649258543;33,0434782608696
"269";2020-11-23;15707;297;11170;30;134;0;108;466;132;0;2021;15;0;33;6;109;163;0;30;30;4240;2153;0,0622387366465397;8,22722916792028;10,5093488072211;26,0869565217391
"270";2020-11-24;15840;298;11391;33;133;1;221;445;78;245;2032;22;0;34;6;116;178;0;33;33;4151;2355;0,0564755838641189;7,74286763887408;11,4764667956157;28,695652173913
"271";2020-11-25;15961;300;11498;32;121;2;107;421;125;31;1961;23;0;36;9;115;183;0;32;32;4163;2117;0,0571563533301842;7,22062421207987;11,7988394584139;27,8260869565217
"272";2020-11-26;16066;304;11589;28;105;4;91;399;88;32;2091;19;0;34;11;101;165;0;28;28;4173;2211;0,0474898236092266;6,78370931660225;10,6382978723404;24,3478260869565
"273";2020-11-27;16201;305;11710;28;135;1;121;386;141;38;2012;16;0;38;7;97;158;0;28;28;4186;2191;0,0616157005933364;6,55296772398058;10,186976144423;24,3478260869565
"274";2020-11-28;16288;311;11767;32;87;6;57;367;0;39;1844;15;0;41;8;102;166;0;32;32;4210;1883;0,0462028677642061;6,01592608541312;10,7027724049001;27,8260869565217
"275";2020-11-29;16377;312;11800;30;89;1;33;360;0;45;788;15;0;43;8;103;169;0;30;30;4265;833;0,106842737094838;6,25745432717785;10,896196002579;26,0869565217391
"276";2020-11-30;16483;316;11979;29;106;4;179;337;104;50;1259;19;0;41;10;96;166;0;29;29;4188;1413;0,0750176928520878;6,44001084439997;10,7027724049001;25,2173913043478
"277";2020-12-01;16685;320;12295;31;202;4;316;324;90;30;2019;18;0;39;13;99;169;0;31;31;4070;2139;0,0944366526414212;6,98231182693286;10,896196002579;26,9565217391304
"278";2020-12-02;16805;321;12552;33;120;1;257;304;90;34;1949;19;0;38;13;107;177;0;33;33;3932;2073;0,0578871201157742;6,99275135244129;11,4119922630561;28,695652173913
"279";2020-12-03;16963;324;12690;33;158;3;138;302;149;48;2087;17;0;38;18;102;175;0;33;33;3949;2284;0,0691768826619965;7,30256648176657;11,2830431979368;28,695652173913
"280";2020-12-04;17098;324;12833;29;135;0;143;296;98;61;1857;12;0;36;17;104;169;0;29;29;3941;2016;0,0669642857142857;7,37897484063728;10,896196002579;25,2173913043478
"281";2020-12-05;17227;328;13145;28;129;4;312;292;3;16;1526;11;0;38;20;100;169;0;28;28;3754;1545;0,083495145631068;7,91172166730673;10,896196002579;24,3478260869565
"282";2020-12-06;17285;331;13344;28;58;3;199;287;0;33;690;10;0;37;23;101;171;0;28;28;3610;723;0,0802213001383126;7,53141542507066;11,0251450676983;24,3478260869565
"283";2020-12-07;17364;342;13714;28;79;11;370;277;113;48;1030;7;0;32;21;94;154;0;28;28;3308;1191;0,0663308144416457;7,40731716206434;9,9290780141844;24,3478260869565
"284";2020-12-08;17452;344;14004;26;88;2;290;270;0;32;1711;7;0;33;23;95;158;0;26;26;3104;1743;0,0504876649454963;6,77947448069399;10,186976144423;22,6086956521739
"285";2020-12-09;17499;347;14469;27;47;3;465;257;85;30;1043;8;0;34;21;92;155;0;27;27;2683;1158;0,040587219343696;6,53233304109287;9,99355254674404;23,4782608695652
"286";2020-12-10;17609;348;14863;28;110;1;394;258;144;38;1528;7;0;32;24;87;150;0;28;28;2398;1710;0,064327485380117;6,46305593706602;9,67117988394584;24,3478260869565
"287";2020-12-11;17686;350;15260;25;77;2;397;249;88;34;1682;6;0;29;19;82;136;0;25;25;2076;1804;0,0426829268292683;6,11617938156577;8,7685364281109;21,7391304347826
"288";2020-12-12;17741;352;15393;25;55;2;133;243;0;21;1453;6;0;32;17;84;139;0;25;25;1996;1474;0,0373134328358209;5,45644062734795;8,96196002578981;21,7391304347826
"289";2020-12-13;17822;353;15577;26;81;1;184;242;0;22;1017;6;0;31;22;89;148;0;26;26;1892;1039;0,0779595765158807;5,42413028988464;9,54223081882656;22,6086956521739
"290";2020-12-14;17896;359;15774;26;74;6;197;236;161;40;1202;6;0;27;22;84;139;0;26;26;1763;1403;0,052744119743407;5,23003465133837;8,96196002578981;22,6086956521739
"291";2020-12-15;17983;363;15835;21;87;4;61;216;80;60;2047;5;1;28;19;80;133;0;21;21;1785;2187;0,0397805212620027;5,07707545585989;8,57511283043198;18,2608695652174
"292";2020-12-16;18065;367;16065;21;82;4;230;209;211;43;1991;6;1;26;21;75;129;0;21;21;1633;2245;0,0365256124721604;5,01905250055224;8,31721470019342;18,2608695652174
"293";2020-12-17;18140;370;16200;21;75;3;135;196;69;72;1777;5;0;27;20;69;121;0;21;21;1570;1918;0,0391032325338895;4,65870603132042;7,80141843971631;18,2608695652174
"294";2020-12-18;18213;372;16344;21;73;2;144;186;247;70;1782;6;0;21;21;64;112;0;21;21;1497;2099;0,0347784659361601;4,54578516141887;7,22114764667956;18,2608695652174
"295";2020-12-19;18245;375;16490;21;32;3;146;170;0;43;1734;6;0;19;21;65;111;0;21;21;1380;1777;0,0180078784468205;4,2699915272903;7,15667311411992;18,2608695652174
"296";2020-12-20;18296;376;16550;21;51;1;60;168;0;58;1606;5;0;20;23;64;112;0;21;21;1370;1664;0,0306490384615385;3,59412669794255;7,22114764667956;18,2608695652174
"297";2020-12-21;18360;376;16582;24;64;0;32;166;79;84;1038;5;0;17;25;64;111;0;24;24;1402;1201;0,0532889258950874;3,60190964296656;7,15667311411992;20,8695652173913
"298";2020-12-22;18422;377;16750;22;62;1;168;162;135;89;1982;6;0;13;22;54;95;0;22;22;1295;2206;0,028105167724388;3,43511887814349;6,1250805931657;19,1304347826087
"299";2020-12-23;18503;378;16808;22;81;1;58;167;139;87;2194;5;0;8;17;48;78;0;22;22;1317;2420;0,0334710743801653;3,39148261968642;5,02901353965184;19,1304347826087
"300";2020-12-24;18562;380;16831;22;59;2;23;159;0;56;1666;5;0;7;16;50;78;0;22;22;1351;1722;0,0342624854819977;3,32232909037368;5,02901353965184;19,1304347826087
"301";2020-12-25;18629;382;16843;23;67;2;12;157;0;64;1447;5;0;15;12;53;85;0;23;23;1404;1511;0,0443414956982131;3,45894380126015;5,48033526756931;20
"302";2020-12-26;18694;382;16851;23;65;0;8;159;49;70;1446;7;0;16;14;54;91;0;23;23;1461;1565;0,0415335463258786;3,79502477096098;5,86718246292714;20
"303";2020-12-27;18767;383;16858;25;73;1;7;158;0;61;1117;8;0;16;10;54;88;0;25;25;1526;1178;0,0619694397283531;4,24245907477262;5,67375886524823;21,7391304347826
"304";2020-12-28;18839;389;16897;21;72;6;39;157;132;66;1382;12;0;12;11;50;85;0;21;21;1553;1580;0,0455696202531646;4,13218327988801;5,48033526756931;18,2608695652174
"305";2020-12-29;18954;390;17073;21;115;1;176;161;95;73;1315;12;0;11;12;49;84;0;21;21;1491;1483;0,0775455158462576;4,83847396734329;5,41586073500967;18,2608695652174
"306";2020-12-30;19067;395;17331;20;113;5;258;166;102;59;2239;13;0;17;11;50;91;0;20;20;1341;2400;0,0470833333333333;5,0329348095314;5,86718246292714;17,3913043478261
"307";2020-12-31;19109;396;17434;22;42;1;103;161;0;57;837;9;0;20;11;53;93;0;22;22;1279;894;0,0469798657718121;5,21461167081446;5,99613152804642;19,1304347826087
"308";2021-01-01;19257;399;17567;21;148;3;133;174;10;47;1677;12;0;21;9;51;93;0;21;21;1291;1734;0,0853517877739331;5,80047298618189;5,99613152804642;18,2608695652174
"309";2021-01-02;19364;401;17643;22;107;2;76;187;19;66;1439;16;0;18;8;51;93;0;22;22;1320;1524;0,0702099737532808;6,21013623514478;5,99613152804642;19,1304347826087
"310";2021-01-03;19450;401;17725;22;86;0;82;193;0;67;1395;17;0;19;7;54;97;0;22;22;1324;1462;0,0588235294117647;6,16519465919352;6,25402965828498;19,1304347826087
"311";2021-01-04;19577;403;17814;25;127;2;89;203;87;78;1150;14;0;18;5;53;90;0;25;25;1360;1315;0,0965779467680608;6,89388503797775;5,8027079303675;21,7391304347826
"312";2021-01-05;19710;403;18016;24;133;0;202;215;82;57;2060;17;0;19;4;55;95;0;24;24;1291;2199;0,0604820372896771;6,65012105859803;6,1250805931657;20,8695652173913
